Player,G,GS,MP,FG,FGA,FG%,2P,2PA,2P%,3P,3PA,3P%,FT,FTA,FT%,ORB,DRB,TRB,AST,STL,BLK,TOV,PF,PTS
Jameel Alausa,24,1,187,21,41,0.512,21,38,0.553,0,3,0,10,20,0.5,8,32,40,8,0,2,11,26,52
Paul Atkinson,30,29,955,206,327,0.63,202,314,0.643,4,13,0.308,112,167,0.671,68,152,220,44,35,23,57,57,528
Jordan Bruner,28,28,906,112,253,0.443,80,154,0.519,32,99,0.323,49,64,0.766,50,207,257,104,29,48,71,49,305
Matthue Cotton,30,1,581,82,201,0.408,37,73,0.507,45,128,0.352,19,32,0.594,13,65,78,28,18,5,21,35,228
Eze Dike,20,0,132,14,37,0.378,12,27,0.444,2,10,0.2,12,19,0.632,4,13,17,15,3,1,17,19,42
Michael Feinberg,11,0,46,8,12,0.667,6,8,0.75,2,4,0.5,7,10,0.7,5,10,15,5,0,0,4,7,25
Jalen Gabbidon,30,30,727,58,140,0.414,36,77,0.468,22,63,0.349,40,54,0.741,23,79,102,39,40,8,36,80,178
Ed Jarvis,10,0,43,7,15,0.467,7,14,0.5,0,1,0,7,13,0.538,8,10,18,3,1,0,2,7,21
Isaiah Kelly,16,0,77,9,17,0.529,9,16,0.563,0,1,0,7,15,0.467,4,5,9,1,2,1,7,7,25
Jake Lanford,9,0,40,4,6,0.667,4,6,0.667,0,0,0,6,8,0.75,3,7,10,3,1,0,3,4,14
August Mahoney,29,0,313,37,69,0.536,19,29,0.655,18,40,0.45,13,15,0.867,7,33,40,22,7,2,14,39,105
Eric Monroe,30,30,888,68,155,0.439,28,64,0.438,40,91,0.44,39,44,0.886,9,89,98,129,22,8,62,59,215
Azar Swain,29,29,971,156,397,0.393,63,157,0.401,93,240,0.388,60,73,0.822,16,101,117,49,19,0,52,26,465
Austin Williams,18,1,88,8,20,0.4,8,14,0.571,0,6,0,13,15,0.867,3,8,11,1,0,0,11,10,29
Wyatt Yess,22,1,246,19,36,0.528,12,21,0.571,7,15,0.467,12,21,0.571,16,48,64,13,11,3,8,24,57
Bryce Aiken,7,6,179,35,85,0.412,22,49,0.449,13,36,0.361,34,39,0.872,2,11,13,12,9,0,26,16,117
Robert Baker,29,26,637,75,159,0.472,49,86,0.57,26,73,0.356,27,33,0.818,26,127,153,22,27,41,37,45,203
Justin Bassey,29,29,809,64,157,0.408,45,87,0.517,19,70,0.271,41,58,0.707,36,123,159,50,25,4,51,51,188
Ciaran Brayboy,6,0,17,1,2,0.5,1,2,0.5,0,0,0,3,4,0.75,0,4,4,1,0,1,4,4,5
Kale Catchings,4,0,23,2,7,0.286,1,1,1,1,6,0.167,1,4,0.25,0,2,2,2,1,0,0,5,6
Danilo Djuricic,29,2,532,62,135,0.459,38,68,0.559,24,67,0.358,30,35,0.857,42,84,126,21,7,11,15,43,178
Reed Farley,2,0,4,0,1,0,0,0,0,0,1,0,0,0,0,0,0,0,0,0,0,0,0,0
Mason Forbes,28,2,283,36,59,0.61,36,59,0.61,0,0,0,28,48,0.583,36,22,58,10,6,18,7,39,100
Spencer Freedman,1,0,2,0,0,0,0,0,0,0,0,0,0,0,0,0,0,0,0,0,0,0,0,0
Rio Haskett,29,6,507,63,150,0.42,30,65,0.462,33,85,0.388,22,29,0.759,11,29,40,25,25,2,31,53,181
Christian Juzang,25,18,621,56,161,0.348,29,65,0.446,27,96,0.281,29,37,0.784,9,54,63,70,14,2,33,38,168
Noah Kirkwood,27,25,779,119,264,0.451,81,159,0.509,38,105,0.362,51,83,0.614,13,88,101,63,28,7,72,57,327
Chris Ledlum,29,1,466,77,183,0.421,62,128,0.484,15,55,0.273,42,68,0.618,34,77,111,21,10,18,47,44,211
Chris Lewis,28,28,728,133,223,0.596,133,223,0.596,0,0,0,52,78,0.667,58,108,166,23,27,44,53,76,318
Tommy O'Neil,7,0,24,2,2,1,1,1,1,1,1,1,0,0,0,0,6,6,1,2,0,0,3,5
Luka Sakota,20,1,140,14,37,0.378,6,14,0.429,8,23,0.348,6,8,0.75,1,11,12,9,1,1,11,17,42
Idan Tretout,16,0,119,22,50,0.44,18,34,0.529,4,16,0.25,13,17,0.765,3,8,11,12,5,2,5,11,61
Henry Welsh,7,1,30,2,5,0.4,2,4,0.5,0,1,0,0,0,0,2,3,5,1,0,2,0,3,4
AJ Brodeur,27,27,934,186,369,0.504,169,307,0.55,17,62,0.274,78,109,0.716,60,180,240,140,29,48,75,60,467
Devon Goodman,27,27,981,142,314,0.452,105,183,0.574,37,131,0.282,47,80,0.588,12,81,93,86,43,8,62,62,368
Jordan Dingle,25,20,783,123,296,0.416,66,128,0.516,57,168,0.339,35,60,0.583,16,69,85,57,20,1,64,48,338
Ryan Betley,22,22,671,91,212,0.429,42,76,0.553,49,136,0.36,25,32,0.781,9,118,127,29,23,7,27,36,256
Max Martz,26,14,621,75,158,0.475,34,63,0.54,41,95,0.432,14,17,0.824,36,60,96,16,5,4,17,40,205
Eddie Scott,25,11,439,42,82,0.512,28,34,0.824,14,48,0.292,21,30,0.7,16,65,81,22,9,1,19,42,119
Lucas Monroe,27,4,401,30,63,0.476,24,47,0.511,6,16,0.375,25,42,0.595,18,69,87,24,16,12,28,46,91
Ray Jerome,19,5,257,15,42,0.357,7,15,0.467,8,27,0.296,9,12,0.75,4,21,25,13,9,2,12,19,47
Jarrod Simmons,26,4,172,13,33,0.394,10,20,0.5,3,13,0.231,12,15,0.8,14,20,34,7,1,4,15,29,41
Bryce Washington,9,1,102,15,39,0.385,9,15,0.6,6,24,0.25,1,1,1,5,13,18,3,4,0,10,8,37
Max Lorca-Lloyd,9,0,31,6,11,0.545,6,11,0.545,0,0,0,0,0,0,4,10,14,4,0,3,4,4,12
Griffin Ryan,5,0,17,2,4,0.5,1,2,0.5,1,2,0.5,1,3,0.333,1,0,1,1,0,0,1,2,6
Alex Imegwu,5,0,10,1,2,0.5,0,0,0,1,2,0.5,1,2,0.5,0,1,1,1,0,0,0,0,4
Mark Jackson,2,0,6,0,0,0,0,0,0,0,0,0,0,2,0,2,0,2,0,0,0,2,1,0
Jaelin Llewellyn,27,27,901,140,358,0.391,92,202,0.455,48,156,0.308,85,109,0.78,21,90,111,62,27,7,49,38,413
Richmond Aririguzoh,27,27,777,127,206,0.617,127,205,0.62,0,1,0,70,107,0.654,77,124,201,60,12,15,85,74,324
Ryan Schwieger,22,18,580,85,186,0.457,57,111,0.514,28,75,0.373,37,42,0.881,15,50,65,58,16,3,53,44,235
Drew Friberg,27,13,700,75,177,0.424,23,45,0.511,52,132,0.394,22,27,0.815,17,79,96,31,33,2,14,44,224
Ethan Wright,26,17,632,66,158,0.418,29,56,0.518,37,102,0.363,17,20,0.85,12,88,100,29,17,5,24,51,186
Jerome Desrosiers,27,1,336,49,101,0.485,23,34,0.676,26,67,0.388,13,17,0.765,10,56,66,17,7,3,9,26,137
Jose Morales,27,1,401,34,71,0.479,20,45,0.444,14,26,0.538,21,26,0.808,2,21,23,45,28,3,24,55,103
Tosan Evbuomwan,26,19,371,41,78,0.526,37,63,0.587,4,15,0.267,16,31,0.516,7,41,48,23,13,9,27,35,102
Ryan Langborg,20,9,324,32,77,0.416,11,18,0.611,21,59,0.356,3,3,1,5,31,36,11,8,5,11,21,88
Keeshawn Kellman,10,0,47,15,22,0.682,15,22,0.682,0,0,0,4,8,0.5,7,5,12,1,0,3,7,2,34
Max Johns,17,3,153,10,27,0.37,9,19,0.474,1,8,0.125,6,8,0.75,3,16,19,12,6,3,9,14,27
Elijah Barnes,17,0,83,9,14,0.643,9,10,0.9,0,4,0,6,9,0.667,4,9,13,4,4,0,6,13,24
Konrad Kiszka,13,0,51,6,14,0.429,5,7,0.714,1,7,0.143,6,8,0.75,1,6,7,3,2,0,3,3,19
Jacob O'Connell,11,0,32,3,7,0.429,2,4,0.5,1,3,0.333,0,0,0,1,8,9,4,0,1,4,2,7
Charlie Bagin,11,0,36,2,4,0.5,0,0,0,2,4,0.5,0,1,0,2,2,4,3,0,0,6,2,6
Colby Kyle,1,0,1,1,1,1,1,1,1,0,0,0,0,1,0,0,0,0,0,0,0,0,0,2
Brandon Anderson,25,25,877,140,385,0.364,92,225,0.409,48,160,0.3,115,140,0.821,23,72,95,74,40,5,89,50,443
Tamenang Choh,27,27,850,123,314,0.392,104,249,0.418,19,65,0.292,91,139,0.655,59,161,220,90,19,15,99,55,356
Zach Hunsaker,27,27,886,109,288,0.378,52,110,0.473,57,178,0.32,72,84,0.857,11,82,93,35,41,3,44,66,347
Jaylan Gainey,25,13,493,63,92,0.685,63,92,0.685,0,0,0,22,32,0.688,41,86,127,9,11,54,22,47,148
Joshua Howard,25,18,451,49,121,0.405,33,63,0.524,16,58,0.276,16,25,0.64,33,55,88,12,15,11,21,39,130
Dan Friday,22,1,362,35,99,0.354,29,83,0.349,6,16,0.375,22,35,0.629,7,31,38,21,7,11,36,37,98
Perry Cowan,27,8,501,35,113,0.31,12,38,0.316,23,75,0.307,0,0,0,8,20,28,10,10,2,14,41,93
David Mitchell,27,2,541,31,63,0.492,23,43,0.535,8,20,0.4,21,29,0.724,49,92,141,20,18,11,19,78,91
Matt DeWolf,23,14,274,31,62,0.5,30,59,0.508,1,3,0.333,10,16,0.625,25,39,64,25,12,4,28,24,73
Davis Franks,11,0,39,3,10,0.3,3,10,0.3,0,0,0,2,5,0.4,9,8,17,4,2,1,6,3,8
Jake Shaper,8,0,23,3,8,0.375,1,2,0.5,2,6,0.333,0,1,0,2,6,8,0,1,1,3,3,8
Josh Watts,13,0,69,2,14,0.143,1,1,1,1,13,0.077,2,4,0.5,2,3,5,3,2,0,3,6,7
Carsten Kogelnik,7,0,25,2,5,0.4,0,1,0,2,4,0.5,0,0,0,1,4,5,0,0,0,2,0,6
EJ Perry,2,0,9,0,2,0,0,0,0,0,2,0,1,2,0.5,0,1,1,1,1,0,1,2,1
Chris Knight,29,28,732,186,335,0.555,185,320,0.578,1,15,0.067,57,94,0.606,51,133,184,57,26,35,77,65,430
Aaryn Rai,29,29,815,122,241,0.506,103,184,0.56,19,57,0.333,62,87,0.713,56,131,187,49,22,14,70,72,325
James Foye,29,29,880,95,226,0.42,35,85,0.412,60,141,0.426,30,40,0.75,3,91,94,62,18,5,32,62,280
Taurus Samuels,29,28,844,85,224,0.379,52,105,0.495,33,119,0.277,42,57,0.737,12,67,79,60,19,2,39,65,245
Ian Sistare,29,27,747,63,182,0.346,29,63,0.46,34,119,0.286,44,56,0.786,8,133,141,35,10,3,30,44,204
Trevon Ary-Turner,26,3,510,52,126,0.413,24,50,0.48,28,76,0.368,18,29,0.621,2,32,34,26,6,3,34,50,150
Ian Carter,29,1,351,31,81,0.383,31,71,0.437,0,10,0,21,30,0.7,15,58,73,19,7,8,23,39,83
Wes Slajchert,29,0,505,24,67,0.358,9,20,0.45,15,47,0.319,8,15,0.533,2,54,56,32,15,0,21,42,71
Garrison Wade,27,0,247,22,57,0.386,15,22,0.682,7,35,0.2,3,6,0.5,5,34,39,10,7,0,10,21,54
Demilade Adelekun,9,0,23,6,11,0.545,6,11,0.545,0,0,,0,1,0,3,4,7,2,0,2,1,5,12
Jackson Blaufeld,10,0,23,4,8,0.5,2,3,0.667,2,5,0.4,2,4,0.5,0,3,3,1,0,0,1,0,12
Nathaniel Ogbu,20,0,57,3,10,0.3,2,8,0.25,1,2,0.5,5,9,0.556,3,10,13,5,1,0,2,14,12
Paul Hudson,22,0,90,4,8,0.5,4,7,0.571,0,1,0,1,5,0.2,4,11,15,3,2,2,5,4,9
Jayden Reaves,7,0,10,2,3,0.667,1,1,1,1,2,0.5,0,0,0,0,1,1,3,1,0,0,0,5
Isaac Letoa,2,0,13,1,3,0.333,1,3,0.333,0,0,0,0,0,0,1,1,2,0,0,0,0,0,2
Ben Swett,2,0,3,0,0,0,0,0,0,0,0,0,0,0,0,1,0,1,0,0,0,0,0,0
Jimmy Boeheim,21,19,642,128,298,0.43,97,193,0.503,31,105,0.295,63,88,0.716,25,93,118,40,15,7,40,30,350
Terrance McBride,27,27,888,128,269,0.476,100,180,0.556,28,89,0.315,58,75,0.773,25,78,103,86,28,3,48,33,342
Josh Warren,27,27,755,82,164,0.5,66,113,0.584,16,51,0.314,48,68,0.706,27,101,128,87,16,21,68,76,228
Bryan Knapp,27,27,724,75,174,0.431,51,118,0.432,24,56,0.429,18,23,0.783,12,51,63,38,18,4,24,51,192
Dean Noll,27,1,470,59,145,0.407,38,81,0.469,21,64,0.328,34,42,0.81,15,49,64,35,29,7,33,54,173
Greg Dolan,22,0,341,37,78,0.474,22,45,0.489,15,33,0.455,16,30,0.533,5,29,34,19,21,4,14,21,105
Kobe Dickson,24,5,377,45,81,0.556,41,70,0.586,4,11,0.364,10,27,0.37,30,44,74,12,9,12,20,52,104
Jordan Jones,14,6,281,35,99,0.354,15,29,0.517,20,70,0.286,12,14,0.857,12,32,44,8,9,2,10,31,102
Riley Voss,26,15,403,35,92,0.38,16,38,0.421,19,54,0.352,0,3,0,8,51,59,40,21,5,19,45,89
Thurston McCarty,21,7,267,24,67,0.358,12,25,0.48,12,42,0.286,11,15,0.733,12,23,35,6,3,8,5,33,71
Marcus Filien,20,0,234,13,34,0.382,9,17,0.529,4,17,0.235,9,12,0.75,11,42,53,4,11,4,9,22,39
Noah Gear,9,1,28,7,9,0.778,7,8,0.875,0,1,0,3,4,0.75,1,3,4,1,0,1,1,4,17
Chaz Mack,7,0,21,1,5,0.2,1,3,0.333,0,2,0,2,6,0.333,0,2,2,1,0,0,2,4,4
Max Samberg,11,0,32,0,1,0,0,1,0,0,0,0,2,2,1,2,4,6,2,0,0,3,4,2
Matt Harshany,7,0,10,0,3,0,0,1,0,0,2,0,0,0,0,1,1,2,1,2,0,1,0,0
Chuks Uzoka,2,0,2,0,0,0,0,0,0,0,0,0,0,0,0,0,0,0,0,0,0,0,0,0
Mike Smith,30,30,1132,250,580,0.431,188,397,0.474,62,183,0.339,122,150,0.813,13,110,123,134,46,0,89,45,684
Ike Nweke,27,23,609,109,207,0.527,109,207,0.527,0,0,0,42,52,0.808,63,81,144,17,12,11,36,68,260
Jack Forrest,27,5,690,92,244,0.377,54,136,0.397,38,108,0.352,19,31,0.613,7,81,88,17,8,4,31,59,241
Jake Killingsworth,30,30,1006,79,215,0.367,28,60,0.467,51,155,0.329,14,19,0.737,14,148,162,47,23,5,32,42,223
Tai Bibbs,30,30,803,64,184,0.348,40,92,0.435,24,92,0.261,42,64,0.656,12,91,103,24,28,6,25,53,194
Randy Brumant,29,29,721,71,163,0.436,58,112,0.518,13,51,0.255,29,45,0.644,42,117,159,35,20,33,35,76,184
Joseph Smoyer,30,2,307,24,56,0.429,24,53,0.453,0,3,0,17,25,0.68,20,41,61,18,3,28,21,39,65
Maka Ellis,6,0,164,15,48,0.313,10,24,0.417,5,24,0.208,1,2,0.5,3,16,19,5,1,1,7,8,36
Luke Bolster,24,1,278,12,41,0.293,8,17,0.471,4,24,0.167,7,12,0.583,1,23,24,21,9,0,20,26,35
Cameron Shockley-Okeke,13,0,143,10,38,0.263,8,17,0.471,2,21,0.095,3,4,0.75,5,19,24,4,7,2,10,13,25
Eddie Turner III,9,0,92,9,25,0.36,7,18,0.389,2,7,0.286,0,0,0,1,8,9,3,6,1,10,18,20
Emmanuel Onuama,13,0,81,5,11,0.455,5,11,0.455,0,0,0,0,2,0,2,17,19,2,1,1,6,13,10
Asa Shannon,4,0,21,3,5,0.6,2,2,1,1,3,0.333,2,2,1,2,3,5,1,0,1,3,5,9
Jake Klores,10,0,28,1,2,0.5,1,2,0.5,0,0,0,0,0,0,0,2,2,0,0,0,1,0,2
Ben Milstein,1,0,0,0,0,0,0,0,0,0,0,0,0,0,0,0,0,0,0,0,0,1,0,0